W W W W W W W W W W W 
W E - - - - - - - K W
W - - - - - - - - - W
W - - - - - - - - - W
W - - - - - - - - - W
W - - - - - - - - - W
W W W W W W W W - C W
W W - - - - - - - - W
W P - - C - - - - - W
W W W W W W W W W W W 

